S...#....
###.#.##.
...#...#.
.#.###.#.
.#.....#G
.#######.
.........
